Arapahoes	Arapahos
Hereroes	Hereros
Idahoes	Idahos
Mandingoes	Mandingos
Mementoes	Mementos
Monsignori	Monsignors
Moriscoes	Moriscos
Navahoes	Navahos
Navajoes	Navajos
Negrilloes	Negrillos
Negritoes	Negritos
Punchinelloes	Punchinellos
Reichstag	Reichstags
Winnebagoes	Winnebagos
abaci	abacuses
abided	abode
abscissae	abscissas
abyeing	abying
acanthi	acanthus	acanthuses
adieus	adieux
agapae	agapai	agapes
ageing	aging
ageratum	ageratums
airbuses	airbusses
albedoes	albedos
alder	alders
alighted	alit
alkalies	alkalis
alluvia	alluvions	alluviums
alnicoes	alnicos
ambuscadoes	ambuscados
amebae	amebas
amnia	amnions
amoebae	amoebas
amphorae	amphoras
anchorpeople	anchorpersons
anchovies	anchovy
anecdota	anecdotes
angelfish	angelfishes
ani	anuses
antalkalies	antalkalis
anted	anteed
anthelices	anthelixes
anthraces	anthraxes
antihelices	antihelixes
antipasti	antipastos
antisera	antiserums
anviled	anvilled
anviling	anvilling
aortae	aortas
apexes	apices
aphelia	aphelions
apparatus	apparatuses
appareled	apparelled
appareling	apparelling
aquae	aquas
aquaria	aquariums
arboreta	arboretums
arced	arcked
archipelagoes	archipelagos
arcing	arcking
armfuls	armsful
arras	arrases
asparagus	asparaguses
atria	atriums
auditoria	auditoriums
aurae	auras
aurorae	auroras
autobuses	autobusses
automata	automatons
aviatrices	aviatrixes
avocadoes	avocados
awaked	awoke	awoken
bacchanalia	bacchanalias
backlighted	backlit
backpedaled	backpedalled
backpedaling	backpedalling
backslid	backslidden
bagfuls	bagsful
bandits	banditti
banjoes	banjos
barbascoes	barbascos
barreled	barrelled
barreling	barrelling
barricadoes	barricados
barricoes	barricos
bassi	bassos
bastinadoes	bastinados
baud	bauds
bayadeer	bayadeers
bayoneted	bayonetted
bayoneting	bayonetting
beat	beaten
beaus	beaux
becudgeled	becudgelled
becudgeling	becudgelling
becursed	becurst
bedeviled	bedevilled
bedeviling	bedevilling
bedriveled	bedrivelled
bedriveling	bedrivelling
beefaloes	beefalos
begirded	begirt
begot	begotten
behoofs	behooves
bejeweled	bejewelled
bejeweling	bejewelling
beleaped	beleapt
benefited	benefitted
benefiting	benefitting
bereaved	bereft
beseeched	besought
bestrewed	bestrewn
bestrid	bestridden	bestrode
bet	betted
beveled	bevelled
beveler	beveller
beveling	bevelling	bevellings
bewrapped	bewrapt
biased	biassed
biasing	biassing
biceps	bicepses
bid	bidden
bided	bode
biennia	bienniums
bilboes	bilbos
bimboes	bimbos
bingeing	binging
biogases	biogasses
biscuit	biscuits
bison	bisons
blackbuck	blackbucks
blended	blent
blessed	blest
blueing	bluing
bobbysocks	bobbysox
bogeyed	bogied
bolivares	bolivars
bolsheviki	bolsheviks
boneyer	bonier
boneyest	boniest
bongoes	bongos
bonito	bonitoes	bonitos
born	borne
botargoes	botargos
boweled	bowelled
boweling	bowelling
bowstringed	bowstrung
box	boxes
bravadoes	bravados
broadcast	broadcasted
brontosauri	brontosauruses
buck	bucks
buckoes	buckos
buffaloes	buffalos
bureaus	bureaux
burned	burnt
bursae	bursas
burst	bursted
bused	bussed
buses	busses
bushbuck	bushbucks
busheled	bushelled
busheling	bushelling	bushellings
bushgoat	bushgoats
businesspeople	businesspersons
busing	bussing
bust	busted
bypassed	bypast
cablecast	cablecasted
cacti	cactus	cactuses
caesurae	caesuras
calamancoes	calamancos
calculi	calculuses
calfs	calves
calicoes	calicos
calyces	calyxes
cambia	cambiums
camisadoes	camisados
campaniles	campanili
canaled	canalled
canaling	canalling
canceled	cancelled
canceling	cancelling
candelabra	candelabrums
cannon	cannons
canvased	canvassed
canvasing	canvassing
caravaned	caravanned
caravaning	caravanning
caravanserai	caravanserais
carbonadoes	carbonados
carcinomas	carcinomata
cargoes	cargos
caroled	carolled
caroling	carolling
caryatides	caryatids
cataloes	catalos
cattaloes	cattalos
caucused	caucussed
caucusing	caucussing
caviled	cavilled
caviling	cavilling	cavillings
celli	cellos
cementa	cementums
cerebella	cerebellums
cerebra	cerebrums
cervices	cervixes
chagrined	chagrinned
chagrining	chagrinning
chairmaned	chairmanned
chairmaning	chairmanning
chamois	chamoix
channeled	channelled
channeling	channelling	channellings
chapeaus	chapeaux
chapeled	chapelled
chapeling	chapelling
chapped	chapt
charismas	charismata
chateaus	chateaux
cheechakoes	cheechakos
cherubim	cherubims
chid	chidden	chided
chirruped	chirrupped
chirruping	chirrupping
chiseled	chiselled
chiseling	chiselling	chisellings
chlamydiae	chlamydias
chorused	chorussed
chorusing	chorussing
chrysalides	chrysalises
cicadae	cicadas
cicatrices	cicatrixes
cicerones	ciceroni
ciscoes	ciscos
citrus	citruses
clad	clothed
claroes	claros
cleaved	cleft	clove	cloven
clipped	clipt
clitorides	clitorises
cloacae	cloacas
cloverleafs	cloverleaves
clueing	cluing
coccyges	coccyxes
cochleae	cochleas
cognomens	cognomina
coifed	coiffed
coiffing	coifing
colcannon	colcannons
colloquia	colloquiums
colossi	colossuses
combated	combatted
combating	combatting
commandoes	commandos
compendia	compendiums
concerti	concertos
conches	conchs
condoes	condos
conged	congeed
congoes	congos
congresspeople	congresspersons
conjunctivae	conjunctivas
conquistadores	conquistadors
consortia	consortiums
continua	continuums
copulae	copulas
corantoes	corantos
corbeled	corbelled
corbeling	corbelling	corbellings
coronae	coronas
corpora	corpuses
cortexes	cortices
cosmos	cosmoses
cottonseed	cottonseeds
counseled	counselled
counseling	counselling	counsellings
countersank	countersunk
courantoes	courantos
cows	kine
craftspeople	craftspersons
cramboes	crambos
crania	craniums
crematoria	crematoriums
creneled	crenelled
creneling	crenelling
crescendi	crescendos
criteria	criterions
croci	crocus	crocuses
crueler	crueller
cruelest	cruellest
crusadoes	crusados
cruzadoes	cruzados
crystaled	crystalled
crystaling	crystalling
cudgeled	cudgelled
cudgeling	cudgelling	cudgellings
cueing	cuing
cumulonimbi	cumulonimbuses
cupeled	cupelled
cupeling	cupelling
cupfuls	cupsful
curricula	curriculums
cursed	curst
cymbaloes	cymbalos
dadoes	dados
dagoes	dagos
damndest	damnedest
danish	danishes
daydreamed	daydreamt
daylighted	daylit
decaled	decalled
decaling	decalling
decrescendi	decrescendos
deer	deers
deliria	deliriums
delphinia	delphiniums
deprogramed	deprogrammed
deprograming	deprogramming
dermatitides	dermatitises
desperadoes	desperados
dessertspoonfuls	dessertspoonsful
develed	develled
develing	develling
deviled	devilled
deviling	devilling
dezinced	dezincked
dezincing	dezincking
diagramed	diagrammed
diagraming	diagramming
dialed	dialled
dialing	dialling	diallings
diazoes	diazos
dicta	dictums
didoes	didos
dildoes	dildos
dilettantes	dilettanti
diminuendoes	diminuendos
disboweled	disbowelled
disboweling	disbowelling
disemboweled	disembowelled
disemboweling	disembowelling
disequilibria	disequilibriums
disheveled	dishevelled
disheveling	dishevelling
dismaler	dismaller
dismalest	dismallest
disproved	disproven
dittoes	dittos
dived	dove
djinn	djinns
dodoes	dodos
dogmas	dogmata
dognaped	dognapped
dognaping	dognapping
dominatrices	dominatrixes
dominoes	dominos
doweled	dowelled
doweling	dowelling
drachmae	drachmai	drachmas
drank	drunk
dreamed	dreamt
dries	drys
driveled	drivelled
driveling	drivelling
drongoes	drongos
dueled	duelled
dueling	duelling	duellings
duodena	duodenums
dwarfs	dwarves
dwelled	dwelt
dybbukim	dybbuks
earthwolf	earthwolves
echoes	echos
edemas	edemata
effluvia	effluviums
elder	older
eldest	oldest
emboweled	embowelled
emboweling	embowelling
empaneled	empanelled
empaneling	empanelling
emporia	emporiums
enameled	enamelled
enameling	enamelling	enamellings
encomia	encomiums
endamebae	endamebas
endamoebae	endamoebas
enemas	enemata
enhaloes	enhalos
ensorceled	ensorcelled
enteritides	enteritises
enureses	enuresises
ephemerae	ephemeras
epiglottides	epiglottises
epithelia	epitheliums
epoxied	epoxyed
equaled	equalled
equaling	equalling
equilibria	equilibriums
eringoes	eringos
eryngoes	eryngos
eucalypti	eucalyptuses
eviler	eviller
evilest	evillest
executrices	executrixes
eyeing	eying
eyeleted	eyeletted
eyeleting	eyeletting
faceted	facetted
faceting	facetting
fandangoes	fandangos
farebeat	farebeaten
farragoes	farragos
farther	further
farthest	furthest
fasciae	fascias
fatsoes	fatsos
faunae	faunas
fellowshiped	fellowshipped
fellowshiping	fellowshipping
femora	femurs
ferreled	ferrelled
ferreling	ferrelling
fettuccine	fettuccines
fezes	fezzes
fianchettoes	fianchettos
fiascoes	fiascos
fibrosarcomas	fibrosarcomata
fibulae	fibulas
ficoes	ficos
ficus	ficuses
fieldstripped	fieldstript
firstborn	firstborns
fistulae	fistulas
fit	fitted
flagella	flagellums
flambeaus	flambeaux
flamingoes	flamingos
flanneled	flannelled
flanneling	flannelling
floodlighted	floodlit
florae	floras
foci	focuses	focusses
focused	focussed
focusing	focussing
folk	folks
fora	forums
forbad	forbade	forbid	forbidden
forecast	forecasted
forehoofs	forehooves
forepeople	forepersons
foreshowed	foreshown
formulae	formulas
fortissimi	fortissimos
frescoes	frescos
frivoled	frivolled
frivoling	frivolling
frusta	frustums
fueled	fuelled
fueling	fuelling
fulcra	fulcrums
fumadoes	fumados
fungi	funguses
funneled	funnelled
funneling	funnelling
gallows	gallowses
gambadoes	gambados
gamboled	gambolled
gamboling	gambolling
ganglia	ganglions
gannet	gannets
gases	gasses
gastritides	gastritises
gaveled	gavelled
gaveling	gavelling
gazaboes	gazabos
gazeboes	gazebos
geckoes	geckos
geisha	geishas
gelded	gelt
gemsbuck	gemsbucks
genera	genuses
gentlefolk	gentlefolks
gheraoes	gheraos
ghettoes	ghettos
gilded	gilt
gimbaled	gimballed
gimbaling	gimballing
gingkoes	gingkos
ginkgoes	ginkgos
ginzoes	ginzos
girded	girt
gladioli	gladiolus	gladioluses
glissandi	glissandos
glottides	glottises
glueing	gluing
gnawed	gnawn
goat	goats
goboes	gobos
gospeled	gospelled
gospeling	gospelling
gossiped	gossipped
gossiping	gossipping
got	gotten
grapefruit	grapefruits
gravamens	gravamina
graved	graven
graveled	gravelled
graveling	gravelling
greenlighted	greenlit
grottoes	grottos
grouse	grouses
groveled	grovelled
groveling	grovelling
grueled	gruelled
grueling	gruelling	gruellings
guacharoes	guacharos
guarani	guaranies	guaranis
gulden	guldens
gymnasia	gymnasiums
haloes	halos
handfuls	handsful
handkerchiefs	handkerchieves
handseled	handselled
handseling	handselling
handwrit	handwritten
hanseled	hanselled
hanseling	hanselling
hatcheled	hatchelled
hatcheling	hatchelling
hawbuck	hawbucks
heathen	heathens
helices	helixes
herniae	hernias
heroes	heros
hertz	hertzes
hewed	hewn
hiatus	hiatuses
hiccuped	hiccupped
hiccuping	hiccupping
hid	hidden
hieing	hying
hillfolk	hillfolks
hilloes	hillos
hippopotami	hippopotamuses
hirseled	hirselled
hirseling	hirselling
hoboes	hobos
hogtieing	hogtying
holloes	hollos
honeyed	honied
honoraria	honorariums
hoofs	hooves
hosteled	hostelled
hosteling	hostelling
houseled	houselled
houseling	houselling	housellings
hoveled	hovelled
hoveling	hovelling
hydrae	hydras
hydrocephali	hydrocephaluses
hydrothoraces	hydrothoraxes
hyperbolae	hyperbolas
hypopharynges	hypopharynxes
iambi	iambuses
ibexes	ibices
ictus	ictuses
ignaroes	ignaros
imagines	imagoes
impaneled	impanelled
impaneling	impanelling
impatiens	impatienses
imperiled	imperilled
imperiling	imperilling
incubi	incubuses
indexes	indices
indigoes	indigos
indwelled	indwelt
initialed	initialled
initialing	initialling
innuendoes	innuendos
input	inputted
inset	insetted
intagli	intaglios
intermezzi	intermezzos
interpleaded	interpled
interregna	interregnums
interweaved	interwove	interwoven
interworked	interwrought
irides	irises
isthmi	isthmuses
jacklighted	jacklit
jejuna	jejunums
jeweled	jewelled
jeweling	jewelling
jigsawed	jigsawn
jinn	jinnis
journaled	journalled
journaling	journalling
juncoes	juncos
kenneled	kennelled
kenneling	kennelling
kerchiefs	kerchieves
kerneled	kernelled
kerneling	kernelling
kiddoes	kiddos
kidnaped	kidnapped
kidnaping	kidnapping
kielbasas	kielbasi	kielbasy
killdeer	killdeers
kilobaud	kilobauds
kilohertz	kilohertzes
kinfolk	kinfolks
kinsfolk	kinsfolks
kip	kips
kneeled	knelt
kuchen	kuchens
labeled	labelled
labeling	labelling
laced	lacked
lacing	lacking
lacunae	lacunas
laded	laden
laminae	laminas
landslid	landslidden
larvae	larvas
larynges	larynxes
lassoes	lassos
lateraled	lateralled
lateraling	lateralling
latexes	latices
lath	laths
latigoes	latigos
laureled	laurelled
laureling	laurelling
lavaboes	lavabos
laypeople	laypersons
leafleted	leafletted
leafleting	leafletting
leaned	leant
leaped	leapt	lept
learned	learnt
least	littlest
less	lesser	littler
leveled	levelled
leveling	levelling
lexica	lexicons
libeled	libelled
libeling	libelling
libretti	librettos
lighted	lit
lingoes	lingos
linguine	linguines
linguini	linguinis
liras	lire
localed	localled
localing	localling
longeing	longing
looneys	loonies
loris	lorises
lowlifes	lowlives
lox	loxes
loyaler	loyaller
loyalest	loyallest
lugeing	luging
lymphomas	lymphomata
macaronies	macaronis
macramed	macrameed
macronuclei	macronucleuses
mademoiselles	mesdemoiselles
maestri	maestros
mafiosi	mafiosos
magnificoes	magnificos
mangoes	mangos
manifestoes	manifestos
mantes	mantises
markkaa	markkas
marquis	marquises
marshaled	marshalled
marshaling	marshalling	marshallings
marveled	marvelled
marveling	marvelling
matrices	matrixes
matzos	matzot	matzoth
mausolea	mausoleums
maxillae	maxillas
maxima	maximums
meaneing	meaning
medaled	medalled
medaling	medalling
medevaced	medevacked
medevacing	medevacking
media	mediums
medullae	medullas
megabuck	megabucks
megafaunae	megafaunas
megahertz	megahertzes
melanomas	melanomata
melted	molten
mementoes	mementos
memoranda	memorandums
menfolk	menfolks
menhaden	menhadens
menisci	meniscuses
mestesoes	mestesos
mestinoes	mestinos
mestizoes	mestizos
metaled	metalled
metaling	metalling	metallings
metathoraces	metathoraxes
miasmas	miasmata
micra	microns
microbuses	microbusses
microcosmos	microcosmoses
microfaunae	microfaunas
microfiche	microfiches
microflorae	microfloras
microfungi	microfunguses
micronuclei	micronucleuses
midwifed	midwived
midwifing	midwiving
milieus	milieux
militaries	military
millennia	millenniums
minibuses	minibusses
minima	minimums
misbiased	misbiassed
misbiasing	misbiassing
mischanneled	mischannelled
mischanneling	mischannelling
misdialed	misdialled
misdialing	misdialling
misfocused	misfocussed
misfocuses	misfocusses
misfocusing	misfocussing
misfueled	misfuelled
misfueling	misfuelling
mislabeled	mislabelled
mislabeling	mislabelling
mislearned	mislearnt
mislighted	mislit
mispleaded	mispled
misprogramed	misprogrammed
misprograming	misprogramming
misshaped	misshapen
misspelled	misspelt
misstricken	misstruck
miswrit	miswritten
modeled	modelled
modeling	modelling	modellings
mojoes	mojos
momenta	momentums
momentoes	momentos
moneys	monies
mongeese	mongooses
mongoes	mongos
monopodia	monopodiums
monsignori	monsignors
moratoria	moratoriums
morseled	morselled
morseling	morselling
mosquitoes	mosquitos
motorbuses	motorbusses
mottoes	mottos
mowburned	mowburnt
mowed	mown
mulattoes	mulattos
multiparae	multiparas
mungoes	mungos
naiades	naiads
narcissi	narcissus	narcissuses
nautili	nautiluses
nebulae	nebulas
neckerchiefs	neckerchieves
necropoleis	necropoles	necropoli	necropolises
neocortexes	neocortices
nephritides	nephritises
neuritides	neuritises
newspeople	newspersons
nexus	nexuses
nickeled	nickelled
nickeling	nickelling
nimbi	nimbuses
nisei	niseis
noes	nos
nonequilibria	nonequilibriums
nonplused	nonplussed
nonpluses	nonplusses
nonplusing	nonplussing
nosedived	nosedove
novae	novas
novellas	novelle
novenae	novenas
nuclei	nucleuses
oak	oaks
obbligati	obbligatos
obi	obis
oboes	obos
octopi	octopuses
offspring	offsprings
omnibuses	omnibusses
opera	opuses
optima	optimums
outburned	outburnt
outcaviled	outcavilled
outcaviling	outcavilling
outchid	outchidden	outchided
outdrank	outdrunk
outdreamed	outdreamt
outdueled	outduelled
outdueling	outduelling
outgases	outgasses
outgnawed	outgnawn
outleaped	outleapt
outlearned	outlearnt
output	outputted
outrivaled	outrivalled
outrivaling	outrivalling
outshined	outshone
outsmelled	outsmelt
outsped	outspeeded
outspelled	outspelt
outstripped	outstript
outwrit	outwritten
overbeat	overbeaten
overburned	overburnt
overdrank	overdrunk
overeyeing	overeying
overfocused	overfocussed
overfocuses	overfocusses
overfocusing	overfocussing
overgilded	overgilt
overgirded	overgirt
overgot	overgotten
overladed	overladen
overleaped	overleapt	overlept
overlighted	overlit
overpassed	overpast
overpedaled	overpedalled
overpedaling	overpedalling
overprogramed	overprogrammed
overprograming	overprogramming
overspilled	overspilt
overstrewed	overstrewn
ox	oxen
oxymora	oxymorons
paced	packed
pacing	packing
pailfuls	pailsful
palebuck	palebucks
palmettoes	palmettos
paneled	panelled
paneling	panelling	panellings
papyri	papyruses
para	paras
paralleled	parallelled
paralleling	parallelling
paramecia	parameciums
parceled	parcelled
parceling	parcelling
passadoes	passados
patellae	patellas
patinae	patinas
peas	pease
peccadilloes	peccadillos
pedaled	pedalled
pedaler	pedaller
pedaling	pedalling
pedaloes	pedalos
pedestaled	pedestalled
pedestaling	pedestalling
pedreroes	pedreros
pelves	pelvises
penciled	pencilled
penciling	pencilling	pencillings
penes	penises
penumbrae	penumbras
people	persons
pericardia	pericardiums
pericrania	pericraniums
perihelia	perihelions
periled	perilled
periling	perilling
peritonea	peritoneums
phalli	phalluses
pharynges	pharynxes
pheasant	pheasants
phenomena	phenomenons
philodendra	philodendrons
phlox	phloxes
phosphori	phosphoruses
pianissimi	pianissimos
piazzas	piazze
pikestaffs	pikestaves
pingoes	pingos
pinkoes	pinkos
pinones	pinons
pintadoes	pintados
pintoes	pintos
pistoled	pistolled
pistoling	pistolling
pizzicati	pizzicatos
placeboes	placebos
placentae	placentas
planetaria	planetariums
plateaus	plateaux
platies	platys
platypi	platypus	platypuses
pleaded	pled
plectra	plectrums
plenipoes	plenipos
plexus	plexuses
pluses	plusses
podia	podiums
poi	pois
politicoes	politicos
polyhedra	polyhedrons
polyneuritides	polyneuritises
pommeled	pommelled
pommeling	pommelling
porticoes	porticos
portmanteaus	portmanteaux
pox	poxes
precalculi	precalculuses
precanceled	precancelled
precanceling	precancelling
prefocused	prefocussed
prefocuses	prefocusses
prefocusing	prefocussing
preprogramed	preprogrammed
preprograming	preprogramming
prepupae	prepupas
preshowed	preshown
preshrank	preshrunk	preshrunken
presidia	presidiums
presterna	presternums
preworked	prewrought
primiparae	primiparas
proboscides	proboscises
procambia	procambiums
programed	programmed
programing	programming
prongbuck	prongbucks
pronuclei	pronucleuses
pronunciamentoes	pronunciamentos
proscenia	prosceniums
prosciutti	prosciuttos
prothoraces	prothoraxes
protocoled	protocolled
protocoling	protocolling
protozoa	protozoans
proved	proven
provisoes	provisos
puma	pumas
pummeled	pummelled
pummeling	pummelling
pupae	pupas
pured	pureed
quadrennia	quadrenniums
quadriceps	quadricepses
quarreled	quarrelled
quarreling	quarrelling	quarrellings
quarterstaffs	quarterstaves
queueing	queuing
quit	quitted
radii	radiuses
radiolabeled	radiolabelled
radiolabeling	radiolabelling
railbuses	railbusses
raveled	ravelled
raveling	ravelling	ravellings
reales	reals	reis
reawaked	reawoke	reawoken
rebatoes	rebatos
rebroadcast	rebroadcasted
recced	recceed
rechanneled	rechannelled
rechanneling	rechannelling
reclad	reclothed
recta	rectums
redialed	redialled
redialing	redialling
redreamed	redreamt
redyeing	redying
reedbuck	reedbucks
reeved	rove
referenda	referendums
refit	refitted
refocused	refocussed
refocuses	refocusses
refocusing	refocussing
reformadoes	reformados
refueled	refuelled
refueling	refuelling
regilded	regilt
reindeer	reindeers
relabeled	relabelled
relabeling	relabelling
relighted	relit
remodeled	remodelled
remodeling	remodelling
renegadoes	renegados
repaneled	repanelled
repaneling	repanelling
repleaded	repled
reprogramed	reprogrammed
reprograming	reprogramming
reshaved	reshaven
reshowed	reshown
resowed	resown
respelled	respelt
resprang	resprung
restricken	restruck
retinae	retinas
retotaled	retotalled
retotaling	retotalling
reveled	revelled
reveling	revelling	revellings
revictualed	revictualled
revictualing	revictualling
rewaked	rewoke	rewoken
reweaved	rewove	rewoven
rewrapped	rewrapt
rhinoceri	rhinoceroses
rhombi	rhombuses
ricocheted	ricochetted
ricocheting	ricochetting
rid	ridded
ripsawed	ripsawn
rivaled	rivalled
rivaling	rivalling
rived	riven
riveted	rivetted
riveting	rivetting
rogueing	roguing
rostra	rostrums
roweled	rowelled
roweling	rowelling
rubati	rubatos
rupiah	rupiahs
salespeople	salespersons
salmonella	salmonellae	salmonellas
salvoes	salvos
sanatoria	sanatoriums
sancta	sanctums
sandaled	sandalled
sandaling	sandalling
sandgrouse	sandgrouses
sanitaria	sanitariums
sank	sunk	sunken
sarcomas	sarcomata
sarcophagi	sarcophaguses
sash	sashes
sauted	sauteed
sawbones	sawboneses
sawed	sawn
scampi	scampies
scandaled	scandalled
scandaling	scandalling
scapulae	scapulas
scarfs	scarves
schemas	schemata
scherzi	scherzos
schmoes	schmos
schrod	schrods
scrod	scrods
scrota	scrotums
semidwarfs	semidwarves
semihoboes	semihobos
sentineled	sentinelled
sentineling	sentinelling
septa	septums
sera	serons	serums
seraphim	seraphs
servicepeople	servicepersons
sewed	sewn
shackoes	shackos
shakoes	shakos
shat	shit
shaved	shaven
sheared	shorn
shier	shyer
shiest	shyest
shod	shodden	shoed
shoes	shoon
shoveled	shovelled
shoveling	shovelling
showed	shown
shrank	shrunk	shrunken
shrived	shriven	shrove
shriveled	shrivelled
shriveling	shrivelling
signaled	signalled
signaling	signalling
signoras	signore
signori	signors
signorinas	signorine
simulcast	simulcasted
sixpence	sixpences
ski	skis
skied	skyed
skydived	skydove
slier	slyer
sliest	slyest
slinked	slunk
smelled	smelt
smit	smitten	smote
smoothes	smooths
snapshot	snapshotted
sneaked	snuck
sniveled	snivelled
sniveling	snivelling
snorkeled	snorkelled
snorkeling	snorkelling
socks	sox
solaria	solariums
soli	solos
sonneted	sonnetted
sonneting	sonnetting
sowed	sown
spacecraft	spacecrafts
spadices	spadixes
spadoes	spados
spat	spats	spit
spec'd	specced	specked
spec'ing	speccing	specking
spectra	spectrums
sped	speeded
spelled	spelt
sphinges	sphinxes
spilled	spilt
spiraled	spiralled
spiraling	spiralling
spoiled	spoilt
spokespeople	spokespersons
spoonfuls	spoonsful
spotlighted	spotlit
sprang	sprung
sprier	spryer
spriest	spryest
springbuck	springbucks
springeing	springing
squash	squashes
squirreled	squirrelled
squirreling	squirrelling
staccati	staccatos
stadia	stadiums
staffs	staves
stag	stags
stank	stunk
staved	stove
stegosauri	stegosauruses
stembuck	stembucks
stenciled	stencilled
stenciling	stencilling	stencillings
sterna	sternums
sticcadoes	sticcados
stilettoes	stilettos
strappadoes	strappados
strata	stratums
stratovolcanoes	stratovolcanos
strewed	strewn
stricken	struck
stripped	stript
strived	striven	strove
stuccoes	stuccos
styli	stylos	styluses
stylopodia	stylopodiums
subdeliria	subdeliriums
subgenera	subgenuses
subimagines	subimagos
subindexes	subindices
submaxillae	submaxillas
subminima	subminimums
substrata	substratums
subtotaled	subtotalled
subtotaling	subtotalling
sunburned	sunburnt
sundries	sundris
supercargoes	supercargos
superhelices	superhelixes
superheroes	superheros
supernovae	supernovas
superphenomena	superphenomenons
superstrata	superstratums
supervirtuosi	supervirtuosos
surplused	surplussed
surplusing	surplussing
swan	swans
sweat	sweated
swelled	swollen
swingeing	swinging
swiveled	swivelled
swiveling	swivelling
syllabi	syllabuses
symboled	symbolled
symboling	symbolling
symposia	symposiums
syngases	syngasses
tableaus	tableaux
tablespoonfuls	tablespoonsful
tableted	tabletted
tableting	tabletting
talced	talcked
talcing	talcking
tarantulae	tarantulas
tasseled	tasselled
tasseling	tasselling	tassellings
taxies	taxis
taxiing	taxying
teargases	teargasses
teaseled	teaselled
teaseling	teaselling
teaspoonfuls	teaspoonsful
teazeled	teazelled
teazeling	teazelling
teetotaled	teetotalled
teetotaling	teetotalling
telecast	telecasted
tempi	tempos
tenderfeet	tenderfoots
termini	terminuses
terraria	terrariums
tetrahedra	tetrahedrons
thermostated	thermostatted
thermostating	thermostatting
thesauri	thesauruses
thoraces	thoraxes
threepence	threepences
thrived	thriven	throve
thunderstricken	thunderstruck
thymi	thymuses
tibiae	tibias
tieing	tyeing	tying
tingeing	tinging
tinseled	tinselled
tinseling	tinselling
tittuped	tittupped
tittuping	tittupping
tobaccoes	tobaccos
togae	togas
tomatilloes	tomatillos
ton	tons
tornadoes	tornados
torpedoes	torpedos
torsi	torsos
tossed	tost
totaled	totalled
totaling	totalling
toweled	towelled
toweling	towelling	towellings
tracheae	tracheas
tradesfolk	tradesfolks
tradespeople	tradespersons
trammeled	trammelled
trammeling	trammelling
tranquiler	tranquiller
tranquilest	tranquillest
transfixed	transfixt
transited	transitted
transiting	transitting
trapezia	trapeziums
traumas	traumata
traveled	travelled
traveling	travelling	travellings
triceps	tricepses
triceratops	triceratopses
trichinae	trichinas
trod	trodden
trolleybuses	trolleybusses
troubleshooted	troubleshot
trousseaus	trousseaux
troweled	trowelled
troweling	trowelling
trueing	truing
tunneled	tunnelled
tunneling	tunnelling	tunnellings
turfs	turves
tuxedoes	tuxedos
twingeing	twinging
tympana	tympanums
tyroes	tyros
ulnae	ulnas
ultimas	ultimata	ultimatums
ultravacua	ultravacuums
umbilici	umbilicuses
umbrae	umbras
unbegot	unbegotten
unbiased	unbiassed
unblessed	unblest
unborn	unborne
unclad	unclothed
underclad	underclothed
undergirded	undergirt
underworked	underwrought
ungilded	ungilt
ungirded	ungirt
unglueing	ungluing
ungot	ungotten
unkenneled	unkennelled
unkenneling	unkennelling
unladed	unladen
unleveled	unlevelled
unleveling	unlevelling
unpeople	unpersons
unraveled	unravelled
unraveling	unravelling	unravellings
unreeved	unrove
unshod	unshoed
untrod	untrodden
unworked	unwrought
up	upped
upspake	upspoke	upspoken
upsprang	upsprung
urethrae	urethras
uteri	uteruses
uvulae	uvulas
vacua	vacuums
vaginae	vaginas
veges	vegs
vermicelli	vermicellis
verrucae	verrucas
vertebrae	vertebras
vertexes	vertices
vertigines	vertigoes	vertigos
viae	vias
vialed	vialled
vialing	vialling
victualed	victualled
victualing	victualling
viragoes	viragos
virtuosi	virtuosos
vitae	vitas
vitrioled	vitriolled
vitrioling	vitriolling
vivaria	vivariums
vogueing	voguing
volcanoes	volcanos
vortexes	vortices
vulvae	vulvas
wainscoted	wainscotted
wainscoting	wainscotting
waitpeople	waitpersons
waked	woke	woken
waldoes	waldos
warwolf	warwolves
waterbuck	waterbucks
waterbuses	waterbusses
wed	wedded
wendigoes	wendigos
wet	wetted
whackoes	whackos
wharfs	wharves
whingeing	whinging
whipsawed	whipsawn
wildfowl	wildfowls
windburned	windburnt
winded	wound
windigoes	windigos
wingeing	winging
wizes	wizzes
wolf	wolves
wolverine	wolverines
womenfolk	womenfolks
worked	wrought
workfolk	workfolks
worshiped	worshipped
worshiping	worshipping
wrapped	wrapt
wrier	wryer
wriest	wryest
writ	written
yeshivahs	yeshivas	yeshivoth
yobboes	yobbos
yodeled	yodelled
yodeling	yodelling
zeroes	zeros
zinced	zincked
zincing	zincking
zucchini	zucchinis
